#domain
hospital
#levelname
MAPF03
#colors
blue: 0
red: 1
green: 2
cyan: 3 
#initial
++++++++++++++
+2     +    3+
++++++ + +++++
+    + +     +
+ ++ +++++++++
+1+  +      0+
++++++++++++++
#goal
++++++++++++++
+      +     +
++++++ + +++++
+    +2+    3+
+ ++ +++++++++
+ +1 +0      +
++++++++++++++
#end
