#domain
hospital
#levelname
MAhelp2
#colors
red: 0, A
green: 1, B
blue: 2, C
#initial
++++++++++++
+  0     + +
+ ++++++++A+
+B     C   +
+++ ++++++ +
+1   2     +
++++++++++++
#goal
++++++++++++
+        +A+
+ ++++++++ +
+          +
+++ ++++++ +
+          +
++++++++++++
#end
