#domain
hospital
#levelname
MAhelp6
#colors
red: 0, A
green: 1, B
blue: 2, C
#initial
++++++++++++
+  0     + +
+ ++++++++A+
+ BC       +
+          +
+1   2     +
++++++++++++
#goal
++++++++++++
+        +A+
+ ++++++++ +
+          +
+          +
+          +
++++++++++++
#end
