#domain
hospital
#levelname
MAsimple1
#colors
green: 0, B
#initial
++++++++++++++++++++++++++++
+                          +
+     0                B   +
+ +++++++++++++++++        +
+                          +
++++++++++++++++++++++++++++
#goal
++++++++++++++++++++++++++++
+                          +
+                       B  +
+ +++++++++++++++++        +
+                          +
++++++++++++++++++++++++++++
#end
