#domain
hospital
#levelname
mb3ma2
#colors
blue: 0, 1, A, B, C
#initial
++++++++++++++++++++
+   C  +  0 1+     +
+ A    +     +     +
+      +     +     +
+   B  +     +     +
+                  +
++++++++++++++++++++
#goal
++++++++++++++++++++
+      +   A + B   +
+      +     +     +
+      +     +     +
+      +     +     +
+                C +
++++++++++++++++++++
#end
